.#....#....
........##.
..##.......
.....#..#..
..#.#......
..#..@..#..
.....#.#...
..##.*.....
.....#..#..
.........##
...#..#....
