......#.#.#
.#.....##..
#.......#.#
...#..#..#.
...##......
.....@##..#
....#.#..#.
...#..#....
...##*...#.
..#...##...
..#.#..#...
